30,30

000000000000000000000000000000
000000211200000000000000000000
000002000010000000000000000000
000001000001000000000000000000
000001000000100000000000000000
000002000000010000000000000000
000000100000001000000000000000
000000010000000100000000000000
000000001000000010000000000000
000000000211130001000000000000
000000000000001000311200000000
000000000000000100000010000000
000000000000000010000001000000
000000000000000003000000100000
000000000000000001000000010000
000000000000000001000000004000
000000000000000001000000000000
000000000000000003000000000000
000000000000000010000000000000
000000000000000100000000000000
000000000000001000000000000000
000000000021130000000000000000
000000000100000000000000000000
000000001000000000000000000000
000000020000000000000000000000
000000010000000000000000000000
000000010000000000000000000000
000000010000000000000000000000
0000000X0000000000000000000000
000000000000000000000000000000

# start at X, end at 4